111&1111111111111111111111111111
11 8 111111111###    11111111111
11 8   ###    #&#        ###   1
1  88  #&#    888        #&#   1
1   88888888888888888888888    1
1           8     ###          1
1           8     #&#          1
1    ###    8888888888888888888&
1    #&#    8                  1
1     88888 8  #####           1
1           8  ##&##           1
1       8888888888     ###     1
1    8888       88     #&#     1
1   88           88888888      1
1111&111111111111111111111111111