1111111111111111111
1 ###          ###1
1 #&#    ###   #&#1
1  8888  #&#    8 1
1     88888888888 1
1        38       1
1         8 ###   1
1  #####  8 #&#   1
1  ###&#  88888888&
1     88888       1
1111111111&11111111