22 | 13 |
11111911111111111111
133         21111111
133    2    21111111
1      2   331111111
1          33  33  1
1  33          33  1
1  33   33         1
1       33     33  9
11111111       33  1
11111111  33       1
11111111  33      21
11111111          21
11111111111111911111