########################################
#                 *  *                 #
#                                      #
#    ! *                               #
#                                      #
#                                      #
#                                      #
#                                      #
#                    *                 #
#                                      #
#                                      #
#                   *                  #
#                                      #
#                                      #
#        *  !                          #
#                                      #
#               *                      #
#                           !          #
#                 *                    #
#        *                             #
#                                      #
#         !      *      *              #
#                                      #
#        *       *               !     #
#                                      #
########################################