########################################
#                                      #
#                                      #
#      *                               #
#                                      #
#                                      #
#                                      #
#                                      #
#                                      #
#                                      #
#                                      #
#                   *                  #
#                                      #
#                                      #
#                                      #
#                                      #
#               *                      #
#                                      #
#                                      #
#                                      #
#                                      #
#                       *              #
#                                      #
#                                      #
#                                      #
########################################