########################################
#                                      #
#                                      #
#    ! *                               #
#                                      #
#                                      #
#                                      #
#                                      #
#                                      #
#                                      #
#                                      #
#                   *                  #
#                                      #
#                                      #
#           !                          #
#                                      #
#               *                      #
#                           !          #
#                                      #
#                                      #
#                                      #
#         !             *              #
#                                      #
#                                !     #
#                                      #
########################################