#######################################
#                                     #
#                                     #
#                                     #
#                                     #
#                                     #
#                   *                 #
#                                     #
#                                     #
#                                     #
#                                     #
#                   !                 #
#                                     #
#                                     #
#                                     #
#                                     #
#                                     #
#                                     #
#                                     #
#                                     #
#                                     #
#                                     #
#                                     #
#                                     #
#                                     #
#######################################