11011
12001
10001
10331
11111