#######################################
#                                     #
#                                     #
#      *                              #
#                                     #
#                                     #
#                                     #
#                                     #
#                                     #
#                                     #
#                                     #
#                                     #
#                                     #
#                                     #
#                                     #
#                                     #
#                                     #
#                                     #
#                                     #
#                                     #
#                                     #
#                                     #
#                                     #
#                                     #
#                                     #
#######################################