271,271,271,271,271,271,271,271,271,271,271,271,164,127,271,271,614,614,614,615,616,271,271,271,271,271,271,271,271,272,272,272,272,272,272,272,272,310,310,272,
309,309,309,309,309,309,309,309,309,309,309,309,202,165,309,309,652,614,614,615,616,309,309,309,309,309,309,309,271,271,271,271,271,271,271,271,271,272,310,310,
272,272,271,272,272,272,272,272,272,272,272,272,202,203,272,272,614,652,614,615,616,272,272,272,272,272,272,272,272,272,272,272,272,272,272,271,272,272,309,310,
272,310,271,272,310,310,310,310,310,310,310,310,240,196,196,310,614,652,614,615,616,310,310,310,625,626,310,310,271,272,272,271,679,680,681,682,272,272,272,310,
271,271,271,272,271,271,271,272,271,272,271,271,240,234,234,272,614,652,614,614,615,616,272,272,663,664,272,272,272,272,272,272,717,718,719,720,310,310,310,310,
271,271,271,272,309,625,626,272,309,271,271,272,240,271,271,271,652,653,614,615,616,654,272,310,310,310,310,310,310,310,310,272,755,756,757,758,310,309,310,310,
229,230,231,232,271,663,664,271,272,309,271,272,240,309,309,309,309,309,614,615,616,271,271,271,272,272,272,272,272,309,310,310,793,794,795,796,309,310,309,310,
267,268,269,270,271,272,271,273,274,275,276,277,278,272,272,272,272,272,614,615,614,614,615,616,272,310,310,310,310,309,271,272,831,832,833,834,272,271,272,309,
305,306,307,308,271,271,272,311,312,313,314,315,316,271,271,271,271,271,614,615,614,615,614,615,616,614,615,616,309,271,272,310,271,309,310,271,272,272,310,310,
343,344,345,346,271,271,799,349,350,351,352,353,309,309,271,272,272,272,614,614,614,615,614,615,616,614,615,614,615,616,614,615,616,310,272,271,272,272,309,271,
271,271,309,271,271,271,837,838,272,271,272,309,271,271,271,271,271,271,652,652,614,614,614,615,614,614,615,614,615,614,615,616,614,615,616,271,272,310,614,615,
271,271,309,271,271,271,272,271,271,309,310,271,271,272,309,309,309,309,309,271,614,652,614,614,652,614,799,800,615,614,615,616,614,615,616,614,615,614,615,616,
271,309,310,271,271,271,272,271,309,309,310,271,272,310,310,271,272,271,272,272,652,652,652,652,653,614,837,838,614,614,615,614,614,615,614,614,615,614,615,616,
271,309,310,271,271,271,272,271,309,309,310,272,271,271,272,271,625,626,271,271,271,272,310,310,271,614,614,614,652,614,614,652,700,701,652,614,614,652,653,654,
271,271,309,309,271,679,680,681,682,310,272,271,271,271,272,272,663,664,271,272,271,272,272,271,271,614,652,652,652,652,652,652,738,739,653,652,652,652,653,654,
271,309,310,271,271,717,718,719,720,310,271,271,272,271,272,272,271,272,272,310,272,272,310,309,309,652,652,653,654,272,272,272,310,271,271,272,310,272,310,272,
271,309,310,272,309,755,756,757,758,310,271,272,271,271,272,271,272,310,310,310,310,310,310,271,309,310,309,271,272,272,310,310,271,271,272,310,310,310,310,310,
271,309,310,271,271,793,794,795,796,272,272,310,309,271,271,272,310,271,271,309,310,272,272,272,272,272,272,272,310,310,309,310,272,272,310,310,272,309,310,310,
309,309,310,271,309,831,832,833,834,310,271,271,271,271,272,272,310,272,309,310,271,271,272,310,310,310,310,310,309,271,309,310,272,310,309,310,310,309,310,272,
271,309,310,309,309,310,310,271,272,309,309,309,271,272,272,310,272,310,309,310,271,271,271,271,271,821,822,823,824,825,826,827,828,829,830,310,310,310,310,310,
309,310,309,310,310,310,272,272,272,272,272,272,271,272,310,310,310,310,272,272,272,272,272,272,272,859,860,861,862,863,864,865,866,867,868,271,271,309,309,310,
309,310,310,310,310,310,310,310,310,310,310,310,272,272,310,271,309,310,310,310,310,310,799,800,310,897,898,899,900,901,902,903,904,905,906,309,309,310,309,310,
271,272,271,309,309,309,309,309,310,271,309,310,310,625,626,309,271,272,271,271,271,271,837,838,309,271,272,310,309,310,309,309,309,309,310,272,272,272,309,310,
271,272,309,309,309,309,309,309,309,271,271,309,309,663,664,309,309,271,271,271,271,309,309,309,271,272,271,271,309,310,271,309,310,310,310,310,310,310,272,272,
309,271,271,272,271,271,271,271,271,309,309,310,271,271,271,271,271,309,309,309,309,310,271,271,271,271,309,309,310,309,309,309,309,309,271,271,271,309,310,310,
309,309,309,271,271,271,271,271,309,310,309,309,309,309,309,309,309,309,309,309,309,309,309,271,271,309,310,309,309,309,309,309,309,309,309,309,309,309,309,309
