111111111111111111111111111111111111111111111111111111111111&11111
111111111111111111111111111111111#####1111111111111111111   8   11
1111111111111111111111111111111  ##&##111111111111111111    8   11
111111111111            111111       1111111111111111111    8    1
111111111        0                  1111111111111111111    88    1
111111            111111          111111111111111111111    8     1
11111            111111111  0       11111111111111111     88 8  11
11111            11111111111            111111111        8      11
1111               11111111111                                1111
1111    8           111111111111                             11111
111                 111111111111144   444                   011111
11    88          111111111111111114 444   444 4411111       11111
1   8 8          11111111111111111144444 444 44111111111       111
&8888        1111111111111111111111111444444111111111111      4 41
111      11111111111111111111111111111111111111111111111111 4  44&
111111111111111111111111111111111111111111111111111111111111111111