111111111111111111111111111111111111111111111111111111111
1 3   111   111111111     111111111111111   1111111111111
1 8    0     111111            111111          1111111111
1  8 888 8   111111                      111       111111
1 88      8  11111     0111111          11111         111
1 8   111     1111     111111111111      111     8     11
1 8   111  8  111    111111111111111111            88   1
&88   1118          11111111111111           1111 8  88 1
1     111       111   111110            111111111111  8 1
1     111      111111             11111111111111111111&11
111111111111111111111111111111111111111111111111111111111