111111111&11111111111111111
11111111      1111111111111
1111111          1111111111
11111               1111111
11111                111111
11111      111        11111
11111XXXXX11111        1111
11111     1111110       111
11111     111111        111
1111      111111          1
111       11111111111     &
111        111111111111   1
1110       1111111111111111
111          11111111111111
111             11111111111
111              ####111111
11111            ##&#111111
111111111              1111
111111111111             11
1111111111111111         11
111111111111111111111&11111