1111111111111111111111111111111111111111
1   11111111     11111111   111111111111
1    11111         11         1111111111
1    11111  !            111      111111
1    1111      1111     11111        111
1 !   111     11111      111          11
1     11    11111111111           !    1
1i         11111111          111       1
1      111   11111!       111111111    1
1     111111          1   11111111111~11
11            111  1111      11111111111
11            111  11111     11111111111
11       111111111        11111111111111
11  !    111111111      1111111111111111
11        11111111              11111111
111       111111111      !      11111111
111       11111111111111        11111111
111        1111111111111         1111111
111        111111111111111111     111111
1111         1111111111111111     111111
111111 !         1111            1111111
111111            !           1111111111
11111111111              111111111111111
1111111111111111111111111111111111111111
1111111111111111111111111111111111111111
1111111111111111111111111111111111111111
