########################################
#                                      #
#                                      #
#    !                                 #
#                                      #
#                          !           #
#                                      #
#                                      #
#                    *                 #
#                                 *    #
#                                      #
#                    *                 #
#                                      #
#                                      #
#           !                          #
#                                      #
#               *                      #
#                                      #
#                 *                    #
#                                      #
#                                      #
#         !                            #
#                                      #
#        *        !                    #
#                                      #
########################################