91111&11111111111111
133         21111111
133    2    21111111
1      2   331111111
1          33  33  1
1  33          33  1
1  33   33         1
1       33     33  &
11111111       33  1
11111111 33       11
11111111 33      211
11111111         211
11111111111111&11118
